111111111111111
100C010E1a10001
1P00001C1 10001
100000001 100C1
111111111111111