111111111
1000010E1
1P0000101
100000001
111111111