111111111
100C01001
1P00001C1
100C00001
111111111